111111111111
1E00000000C1
101111110101
100000000101
1011111C0101
10P000000001
10C111111101
111111111111
