111111111111
1E00000000C1
101111110111
10C000000101
1011111C0101
10P100000001
10C111111101
111111111111
