1111111111111111111111
1000000000000000000001
1011111111111111110101
10000000000000000100C1
1011111111111110110101
1010100000001010101001
101010111110101010E101
1010000000101010100101
1011111111101010101101
10C0000000001010100001
1011111111111010111111
10P0000000000000000001
1111111111111111111111
